NO test.xpm
SO test.xpm
EA test.xpm
WE test.xpm

F 15,15,15
C 20,20,20

111111111
1000N0001
100000001
100000001111
    100000001
100000001111
111111111