NO maps/textures/crate3_8.xpm
SO maps/textures/crate3_8.xpm
EA maps/textures/crate3_8.xpm
WE maps/textures/crate3_8.xpm

F 15,15,15
C 20,20,15

111111111111111111111111111111
100000000000000000000000000001
101111111111111111111111110001
100010000000000000000000010001
100010111111111111111110010001
100010100000000000000010010001
100010101111111111111010010001
100010101000000000001010010001
100010101011111110001010010001
100010101010000010001010010001
100010101010101010101010010001
100010101010101010101010010001
100010101010101010101010010001
100010101010101N10101010010001
100010101010101010101010010001
100010101010101010101010010001
100010101010101010101010010001
100010101010101010101010010001
100010101010101010101010010001
100010101010101010101010010001
100010101010101010101010010001
100010101010101010101010010001
100010101010101010101010010001
100010101010101010101010010001
100010101010101010101010010001
100010101010101010101010010001
100010101010101010101010010001
100010101010101010101010010001
100000000000000000000000000001
111111111111111111111111111111