NO maps/textures/crate3_8.xpm
SO maps/textures/crate3_8.xpm
EA maps/textures/crate3_8.xpm
WE maps/textures/crate3_8.xpm

F 249,156,195
C 104,156,195

1111111111111
1000000000001
1000000000001
100000S000001
1000000000001
1000000000001
1111111111111